U...............................................................................
......########....................................................########......
...s..#.........Z........................................................#......
...S..#.......................+...................................Z......#......
...A..#..................................................................#......
.........................................................+......................
...........Z...................................Z................................
.....................................W..........................................
....................................WWW.........................................
..................................WWWWWWW..................................Z....
...............+................WWWWWWWWWWW................+....................
..............................WWWWWWWWWWWWWWW...................................
..............................WWWWWWWWWWWWWWW...................................
................................WWWWWWWWWWW............Z........................
..................................WWWWWWW.......................................
....................................WWW.........................................
.....................................W.........................ZZZ..............
...............................................................ZGZ..............
....................Z..........................................ZZZ..............
......#...........................................Z......................#......
......#..................................................................#......
......#.......................................................+++........#......
......########.............................+......................########......
.........................+.................................Z....................